M90000000000000000000000000000009
M00000000000000000000000000000000
M00000000000000000000000000000000
M00000000000000000000090000000000
M00000000000000009000090000000000
M00000000000000009000090000000000
M00000000000000009000090000000000
M00000000000000009000090000000000
M00000000000000009000090000000000
M00000000000000009000090000000000
M00000000000000009000090000000000
M00000000000999999999990000000000
M00000000000000000000000000000000
M00000000000000000000000000000000
M00000000000000000000000000000000
M00000000000000000000000000000000
M90000000000000000000000000000009
S1,1
E30,15
S1,1
E20,10
S1,1
E23,10