90000000000000000000000000000009
0s000000000000000000000000000000
00000000000000000000000000000000
00000000000000000000090000000000
00000000000000009000090000000000
00000000000000009000090000000000
00000000000000009000090000000000
00000000000000009000090000000000
00000000000000009000090000000000
00000000000000009000090000000000
00000000000000009000090000000000
00000000000999999999990000000000
00000000000000000000000000000000
00000000000000000000000000000000
00000000000000000000000000000000
000000000000000000000000000000t0
90000000000000000000000000000009
Basic map for checking algo works and showing the benefits of heuristics