M99000000000000000000000000000099
M90000000000000000000000000000009
M00000000000000000000000000000000
M00000000000000000000000000000000
M00000000000000000000000000000000
M00000000000000000000000000000000
M00000000000000000000000000000000
M00000000000000000000000000000000
M00000000000000000000000000000000
M00000000000000000000000000000000
M00000000000000000000000000000000
M00000000000000000000000000000000
M00000000000000000000000000000000
M00000000000000000000000000000000
M00000000000000000000000000000000
M90000000000000000000000000000009
M99000000000000000000000000000099
S1,8
E15,8
S1,1
E15,1
E1,15
E15,15