00000000000000000000000000000000
00000000010000000000000000000000
00s01000000000011111100000000001
00000000000000000000000000000000
00100000100000000000000000000000
00000000100001000000001111000000
00000000100000000000000000000000
00000000100000000000000000000000
00001000100000001000000010000000
00000000000000001000000000000000
00000000001000001000000000000000
00000000000000001000000000000000
00111110010000001000000111111101
000000000000000000000001t0000100
00000000000110000000000100010000
01000000000000000000000111000000
00000000100000000000000000000000
Test basic obstacle navigation