M00000000000000000000000000000000
M00000000090000000000000000000000
M00009000000000099999900000000009
M00000000000000000000000000000000
M00900000900000000000000000000000
M00000000900009000000009999000000
M00000000900000000000000000000000
M00000000900000000000000000000000
M00009000900000009000000090000000
M00000000000000009000000000000000
M00000000009000009000000000000000
M00000000000000009000000000000000
M00999990090000009000000999999909
M00000000000000000000000900000900
M00000000000990000000000900090000
M09000000000000000000000999000000
M00000000900000000000000000000000
S2,2
E25,13