00000000000000000000000000000000
00000000090000000000000000000000
00s09000000000099999900000000009
00000000000000000000000000000000
00900000900000000000000000000000
00000000900009000000009999000000
00000000900000000000000000000000
00000000900000000000000000000000
00009000900000009000000090000000
00000000000000009000000000000000
00000000009000009000000000000000
00000000000000009000000000000000
00999990090000009000000999999909
000000000000000000000009t0000900
00000000000990000000000900090000
09000000000000000000000999000000
00000000900000000000000000000000
Test basic obstacle navigation