00999999999999000000000000000000
00900090009t09000000000000000000
00909090909009000000000000000000
00909090909099000000000000000000
00909090909009000000000000000000
00909090909909000000000000000000
00909000900009000000000000000000
00909999999999000000000000000000
009s9000000000000000000000000000
00989000000000000000000000000000
00989000000000000000000000000000
00989000000000000000000000000000
00989000000000000000000000000000
00989000000000000000000000000000
00989000000000000000000000000000
009t9000000000000000000000000000
00999000000000000000000000000000
Test node costs