M00999999999999000000000000000000
M00900090009009000000000000000000
M00909090909009000000000000000000
M00909090909099000000000000000000
M00909090909009000000000000000000
M00909090909909000000000000000000
M00909000900009000000000000000000
M00909999999999000000000000000000
M00909000000000000000000000000000
M00989000000000000000000000000000
M00989000000000000000000000000000
M00989000000000000000000000000000
M00989000000000000000000000000000
M00989000000000000000000000000000
M00989000000000000000000000000000
M00909000000000000000000000000000
M00999000000000000000000000000000
S3,8
E11,1
E3,15