00000000000000000000000000000000
00000000000000t00000000000000000
00999999999999999999999999999000
00900000000090900000000000009000
00909099999990009999909099999000
00909090009000999000009090009000
00909099909090900099909099909000
00909090009090999090009090009000
00909090999090009090999090999000
00909090000090909090909090009000
00909099999990909090909099909000
00909000000000909090909090009000
00909999999999909990909000999000
00909000000000009000900090009000
00909999999999999999999999999000
0000s000000000000000000000000000
00000000000000000000000000000000
Maze