00000000000000000000000000000000
00000000000000t00000000000000000
00111111111111111111111111111000
00100000000010100000000000001000
00101011111110001111101011111000
00101010001000111000001010001000
00101011101010100011101011101000
00101010001010111010001010001000
00101010111010001010111010111000
00101010000010101010101010001000
00101011111110101010101011101000
00101000000000101010101010001000
00101111111111101110101000111000
00101000000000001000100010001000
00101111111111111111111111111000
0000s000000000000000000000000000
00000000000000000000000000000000