M00000000000000000000000000000000
M00000000000000000000000000000000
M00999999999999999999999999999000
M00900000000090900000000000009000
M00909099999990009999909099999000
M00909090009000999000009090009000
M00909099909090900099909099909000
M00909090009090999090009090009000
M00909090999090009090999090999000
M00909090000090909090909090009000
M00909099999990909090909099909000
M00909000000000909090909090009000
M00909999999999909990909000999000
M00909000000000009000900090009000
M00909999999999999999999999999000
M00000000000000000000000000000000
M00000000000000000000000000000000
S4,15
E14,1
S4,15
E27,3