01010101010101010101010101010101
1010101010101010101010101010t010
01010101010101010101010101010101
10101010101010101010101010000010
01010101010101010000000000010101
10101010101010000010101010001010
01010101010101010101010101010101
10101010101010001010101010101010
01010101010101010101010101010101
10101010101010001010101010101010
01010101000000010101010101010101
10001010001010101010101010101010
01000000010101010101010101010101
10001010101010101010101010101010
00010101010101010101010101010101
1s101010101010101010101010101010
01010101010101010101010101010101