09090909090909090909090909090909
9090909090909090909090909090t090
09090909090909090909090909090909
90909090909090909090909090000090
09090909090909090000000000090909
90909090909090000090909090009090
09090909090909090909090909090909
90909090909090009090909090909090
09090909090909090909090909090909
90909090909090009090909090909090
09090909000000090909090909090909
90009090009090909090909090909090
09000000090909090909090909090909
90009090909090909090909090909090
00090909090909090909090909090909
9s909090909090909090909090909090
09090909090909090909090909090909
?