M09090909090909090909090909090909
M90909090909090909090909090900090
M09090909090909090909090909090909
M90909090909090909090909090000090
M09090909090909090000000000090909
M90909090909090000090909090009090
M09090909090909090909090909090909
M90909090909090009090909090909090
M09090909090909090909090909090909
M90909090909090009090909090909090
M09090909000000090909090909090909
M90009090009090909090909090909090
M09000000090909090909090909090909
M90009090909090909090909090909090
M00090909090909090909090909090909
M90909090909090909090909090909090
M09090909090909090909090909090909
S1,15
E28,1