M00000000000000000000000000000000
M00000000000000000000000000000000
M00000000000000000000000000000000
M00000000999999909999999000000000
M00000000000000909000000000000000
M99999999999900989009999999999999
M00000000000000989000000000000000
M00999999999999979999999999999900
M00000000000000969000000000000000
M00000000000000959000000000000000
M00000000000000949000000000000000
M00000000000000939000000000000000
M00000000000000929000000000000000
M00000000000000989000000000000000
M00000000000000000000000000000000
M00000000000000000000000000000000
M00000000000000000000000000000000
S15,14
E15,2