00000000000000000000000000000000
00000000000000000000000000000000
00000000000000000000000000000000
00000000000000000000000000000000
00011111111111111000000000000000
00010000000000001000000000000000
00010000000010001000000000000000
000100000001t1001000000000000000
000100s0000010001000000000000000
00010000000000001000000000000000
00010000000000001000000000000000
00011111111111111000000000000000
00000000000000000000000000000000
00000000000000000000000000000000
00000000000000000000000000000000
00000000000000000000000000000000
00000000000000000000000000000000