00000000000000000000000000000000
00000000000000000000000000000000
00000000000000000000000000000000
00000000000000000000000000000000
00099999999999999000000000000000
00090000000000009000000000000000
00090000000090009000000000000000
000900000009t9009000000000000000
000900s0000090009000000000000000
00090000000000009000000000000000
00090000000000009000000000000000
00099999999999999000000000000000
00000000000000000000000000000000
00000000000000000000000000000000
00000000000000000000000000000000
00000000000000000000000000000000
00000000000000000000000000000000
Test impossible path detection