M00000000000000000000000000000000
M00000000000000000000000000000000
M00000000000000000000000000000000
M00000000000000000000000000000000
M00099999999999999000000000000000
M00090000000000009000000000000000
M00090000000090009000000000000000
M00090000000909009000000000000000
M00090000000090009000000000000000
M00090000000000009000000000000000
M00090000000000009000000000000000
M00099999999999999000000000000000
M00000000000000000000000000000000
M00000000000000000000000000000000
M00000000000000000000000000000000
M00000000000000000000000000000000
M00000000000000000000000000000000
S6,8
E12,7