00000000000000000000000000000000
00000000000000000000000000000000
000000000000000t0000000000000000
00000000999999909999999000000000
00000000000000909000000000000000
99999999999900989009999999999999
00000000000000989000000000000000
00999999999999979999999999999900
00000000000000969000000000000000
00000000000000959000000000000000
00000000000000949000000000000000
00000000000000939000000000000000
00000000000000929000000000000000
00000000000000919000000000000000
000000000000000s0000000000000000
00000000000000000000000000000000
00000000000000000000000000000000
Test node cost (easy start)