M99000000000000000000000000000099
M90000000000000000000000000000009
M00000000000000000000000000000000
M00000000000000000000000000000000
M00000000000000000000000000000000
M00000099900000000099900000000000
M00000000900000000090000000000000
M00000000900000000090000000000000
M00000000900000000090000000000000
M00000099900000000099900000000000
M00000000000000000000000000000000
M00000000000000000000000000000000
M00000000000000000000000000000000
M00000000000000000000000000000000
M00000000000000000000000000000000
M90000000000000000000000000000009
M99000000000000000000000000000099
S7,7
E19,7
S9,7
E19,7
S7,7
E17,7